40 40
8888888888888888888888888888888888888888
1000000000000000000000000000000000000001
1000000000000000000000000000000000000001
1000000000000000000000000000000000000001
1000000000000010101010101000000000000001
1000000000000000000000000000000000000001
1000000000000000000000000000000000000001
1000000000000000000000000000000000000001
1000000000000000000000000000000000000001
1000000000000000000000000000000000000001
1000002222200000000000000000000303030001
1000002000200000000000000000000000000001
1000002000200000000000000000000300030001
1000002000200000000000000000000000000001
1077762202200000000000000000000303030001
1080000000080000000000000000000000000001
1070864328800000000000000000000000000001
1070000000000000000000000000000000000001
1088887788800000000000000000000000000001
1000000000000000000000000000000000000001
1000000044444430000000000000000000000001
1000000040000430000000000000000000000001
1444444440460430000000000000000000000001
1400000040460430000000000000000000000001
1400005040460630000000000000000000000001
1404000040400000000000000000000000000001
1409999990400000000000000000000000000001
1400000000400000000000000000000000000001
1444444444400000000000000000000000000001
1000000000000000000000000000000000000001
1000000000000000000000000000006606000001
1000000000000000000000000000066006000001
1000000000000000000000000000000066000001
1000000000000000000000000000066660000001
1000000220550990000000033330000000000001
1000000000000000000000037330000000000001
1000000000000000000000030330000000000001
1000000000000000000000000000000000000001
1000000000000000000000000000000000000001
7777777777777777777777777777777777777777
